



################################
#                              #
#                              #
#                              #
#                              #
#                              #
#                              #
#               o o   o        #
#           #############      #
#                              #
#                              #
#            o o o             #
#    ###############           #
#                              #
#                              #
#                              #
#                              #
#              #vvvvvvvvvvv#   #
################################



